..................
..#...............
..#..........E....
..#####...........
..........####....
..................
.......G..........
..........#####...
..................
..................
...........#####..
##################
