...........................
...........................
.............G.............
...........######..........
...........................
......................E....
............########.......
...........................
....#####..................
...........................
..........####.............
.......E...................
..................#####....
........E..................
................####.......
...........................
..............#######......
...........................
...........................
###########################