....................
....#####...........
..E.....#.......E...
..#####.#...........
........#...........
........#####.......
............#.......
..####......#.......
..#..#..G...#.......
..#######.#####.....
....................
####################
