......................
.....E............E...
........####..........
..#####.....#####.....
.............#........
......#####..#........
......#...#..#........
..#####.G.#..#.....E..
..........#..########.
..E.......#...........
......#####...........
......................
######################
