...........................
...........................
...........................
......GE...................
.....###..#................
...............E...........
.......####................
...E...................E...
..........#####............
...........................
...............#####.......
...........................
.............####..........
...........................
..........#####............
...........................
.....####..................
...........................
...........................
###########################